NO     ./images/NO.xpm
SO     ./images/SO.xpm
WE     ./images/WE.xpm
EA      ./images/EA.xpm

C 100,100,0
F 100,0,100

1111111111111111111111111111111111
1000000010000000100000000000000001
1000000010000000D00000000000000001
1000000010000000100000000000000001
1000000010000111111111111D11111111
1111D11110000100000000000000000001
10000000000001000000000000000000N1
1000000000000D00000000000000000001
1000000010000100000000000000000001
1000000010000100000000000000000001
1000000010000100000000000000000001
1000000010000100000000000000000001
100000001000011111111111D1111111D1
1000000010000000000000000000000D01
10000000D0000000000000000000000101
1000000010000111111111111111111101
1000000010000100000000000000000001
1000000010000D00000000000000000001
1000000010000100000000000000000001
1111111111111111111111111111111111










1111111111