NO     ./images/NO.xpm
SO     ./images/SO.xpm
WE     ./images/WE.xpm
EA     ./images/EA.xpm

C 140, 180, 210
F 50, 50, 50


1111111111111111111111111111111111
1000000000000000000000000000000001
1000000000000000000000000000000001
1000000000000111111111111000000001
1000000000N000000000000000000000001
1000000000000000000000000000000001
1000000000000000011110000000000001
1111111111111111111111111111111111

1111111111111111111111111111111111
1000000000000000000000000000000001
1000000000000000000000000000000001
1000000000000000000000000000000001
1000000000000000000110000000000001
1000000000000000001000000000000001
1000000000000000000000000000000001
1111111111111111111111111111111111


