NO     ./images/NO.xpm
SO     ./images/SO.xpm
WE     ./images/WE.xpm
EA     ./images/EA.xpm

C 200,0,0
F 100,0,100


1111111111111111111111111111111111
1000000000000000000000000000000001
1000000000000000000000000000000001
1000011000001000110000000000000001
100000000N000001000100000000111101
1000001000000001111100000011111001
100000011000000111111110000000001
10000000000000000001   111000011
11111111111111111111      1111
