NO  ./images/ta7alib1.xpm
SO ./images/ta7alib2.xpm
WE ./images/ta7alib3.xpm
EA ./images/ta7alib4.xpm

C 200,0,0
F 100,0,100



               111111111111
               100000000001
               100000000001
               100000000001
               100000000001
               10000S000001
               100000000001
               100000000001
               100000000001
               100000000001
               100000000001
               111110011111
                   1001
                   1001
                   1001
111111111111       1D11       111111111111
100000000001      100001      100000000001
101111111101     10000001     101111111101
100000000101    1000000001    100000001101
1000000001011111000000000011111111111D1101
100000000100000D0000000000D0000000D0001001
10000000010000010000000000D000000110001001
100000000111111100000000001111100100110001
100000000001    1000000001    1001010D0001
100000000001     10000001     111101010001
100000000001      100001      100000010001
111111111111       1001       111111111111
                   1001
                   1001
                   1001
               111110011111
               100000000001
               100000000001
               100000000001
               100000000001
               100000000001
               100000000001
               100000000001
               100000000001
               100000000001
               100000000001
               111111111111



