NO  ./images/ta7alib1.xpm 
SO ./images/ta7alib2.xpm
WE ./images/ta7alib3.xpm
EA ./images/ta7alib4.xpm

C 200,0,0
F 100,0,100



               111111111111
               100000000001
               100000000001
               100000000001
               100000000001
               10000S000001
               100000000001
               100000000001
               100000000001
               100000000001
               100000000001
               111110011111
                   1001
                   1001
                   1001
111111111111       1D11       111111111111
100000000001      100001      100000000001
100000000001     10000001     100000000001
100000000001    1000000001    100000000001
100000000001111100000000001111100000000001
100000000000000D0000000000D000000000000001
10000000000000010000000000D000000000000001
100000000001111100000000001111100000000001
100000000001    1000000001    100000000001
100000000001     10000001     100000000001
100000000001      100001      100000000001
111111111111       1001       111111111111
                   1001
                   1001
                   1001
               111110011111
               100000000001
               100000000001
               100000000001
               100000000001
               100000000001
               100000000001
               100000000001
               100000000001
               100000000001
               100000000001
               111111111111
